1 1 1 1 1 1 1 1 1 1 1 1 1 1 1 1 1 1 1 1 1 1 1
1 0 0 0 0 0 0 0 0 0 0 0 0 0 0 0 0 0 0 0 0 0 1
1 6 0 4 0 0 0 0 0 0 0 0 0 0 0 0 0 0 0 5 7 0 1
1 0 0 5 0 0 0 0 0 0 9 0 0 0 0 0 0 0 0 4 0 0 1
1 1 1 1 0 0 0 0 8 0 0 0 0 0 0 0 0 0 0 1 1 1 1
1 1 1 0 0 0 0 1 1 -1 0 0 0 -1 1 1 0 1 0 0 1 1 1
1 1 0 0 0 8 0 0 0 0 0 0 0 0 0 0 0 0 0 0 0 1 1
1 0 0 0 1 1 0 0 0 0 0 0 0 0 0 0 0 0 0 0 0 0 1
1 0 0 0 0 0 0 4 0 5 0 0 5 0 4 0 0 0 0 0 0 0 1
1 0 0 0 0 8 0 0 0 0 0 0 0 0 0 0 0 0 0 0 0 0 1
1 0 0 0 -1 1 1 2 2 2 1 1 3 3 3 1 1 0 0 0 0 0 1
1 0 0 0 0 0 0 0 0 0 0 0 0 0 0 0 0 1 1 0 0 0 1
1 0 0 0 0 0 0 0 0 0 0 0 0 0 0 0 0 0 0 0 0 0 1
1 9 0 0 0 0 0 0 0 0 4 0 0 0 0 0 4 0 0 0 0 1 1
1 0 0 0 0 0 0 5 0 0 1 0 0 5 0 0 1 0 1 1 0 0 1
1 0 0 0 0 0 1 1 0 0 0 0 0 1 1 0 0 0 0 0 0 0 1
1 1 1 1 1 -1 -1 -1 -1 -1 -1 -1 -1 -1 -1 -1 -1 -1 -1 -1 -1 1 1